■■■■■■■■■■■■■■■■■■■■■■■■■■■■■■■■■■■■■■■■■■■■■■■■■■
■ ¶            ¶  ■                              ■
■       E         ■                              ■
■                 ■                              ■
■       ☻         ■                              ■
■                 ■                              ■
■■■■■                                            ■
■                                                ■
■                                                ■
■                                                ■
■                                                ■
■                                                ■
■                                                ■
■                                                ■
■                                                ■
■■■■■■■■■■■                                      ■
■ $       ■            ☻                         ■
■         ■                              X       ■
■         ▓                                      ■
■■■■■■■■■■■■■■■■■■■■■■■■■■■■■■■■■■■■■■■■■■■■■■■■■■