■■■■■■■■■■■■■■■■■■■■■■■■■■■■■■■■■■■■■■■■■■■■■■■■■■
■                                        ■     $ ■
■       E                                ▓       ■
■                 ■                      ■       ■
■                 ■                      ■     ¶ ■
■                 ■          ■■■■■■■■    ■■■■■■■■■
■■■■■■■■■■■■■■■■■■■          ■                   ■
■               ¶ ■          ■                   ■
■                 ■          ■                   ■
■                 ■          ■                   ■
■                 ■          ■                   ■
■                 ■          ■                   ■
■                 ■          ■                   ■
■  ☻              ■          ■ ¶              ☻  ■
■         ■   ■■■■■          ■■■■■■■■■■■■■■■■■■■■■
■■■■■■■■■■■                           ■          ■
■ $       ■                           ■       X  ■
■         ■                           ▓          ■
■         ▓                           ■          ■
■■■■■■■■■■■■■■■■■■■■■■■■■■■■■■■■■■■■■■■■■■■■■■■■■■