■■■■■■■■■■■■■■■■■■■■■■■■■■■■■■■■■■■■■■■■■■■■■■■■■■
■  ♣♣♣♣♣♣♣♣♣♣♣           ☻               ■     $ ■
■       E                                ▓       ■
■ #               ■                      ■       ■
■           $ $   ■                      ■     ¶ ■
■$ $ $ $ $ $ $ $  ■          ■■■■■■■■    ■■■■■■■■■
■■■■■■■■■■■■■■■■■■■          ■  ☻              ☻ ■
■               ¶ ■          ■                   ■
■                 ■          ■                   ■
■                 ■          ■                   ■
■                 ■          ■                   ■
■                 ■          ■                   ■
■                 ■          ■                   ■
■  ☻              ■          ■ ¶              ☻  ■
■         ■   ■■■■■          ■■■■■■■■■■■■■■■■■■■■■
■■■■■■■■■■■                           ■          ■
■ $       ■                           ■       X  ■
■         ■                           ▓          ■
■         ▓                           ■          ■
■■■■■■■■■■■■■■■■■■■■■■■■■■■■■■■■■■■■■■■■■■■■■■■■■■