■■■■■■■■■■■■■■■■■■■■■■■■■■■■■■■■■■■■■■■■■■■■■■■■■■
■                                                ■
■                                                ■
■                                                ■
■       ☻                                        ■
■                        ☻                       ■
■                                                ■
■                                                ■
■                                                ■
■                                 ☻              ■
■                                                ■
■                                                ■
■                                                ■
■                                                ■
■                                                ■
■                                                ■
■■■■■■■■■■            ☻                 ■■■■■■■■■■
■        ■                              ■      X ■
■    E                                           ■
■■■■■■■■■■■■■■■■■■■■■■■■■■■■■■■■■■■■■■■■■■■■■■■■■■